string	string	string
MailType	Title	Content
邮件模板	标题	邮件内容
DefaultLackSpace	背包空间不足	您的背包空间不足，物品已通过邮件发放，请注意查收！
TowerDayPrize	符印塔每日奖励	每日凌晨5点，根据你所处的符印塔层数，发放奖励
TowerPrize	符印塔结算	您的背包空间不足，现将结算奖励发放
FamilyMatch	仙盟联赛通知	仙盟联赛将于近日21:00开启，请准时参加
KillBoss	BOSS击杀活动	您在{0}活动中，击杀了{0}只BOSS，这是奖励
BourseSell	集市物品出售收益	您的{0}已售出，卖出{0}仙玉,税费{0}仙玉，共获得{0}仙玉。
BourseTimeOut	集市过期物品	您在集市上架的物品已过期，现发送给您。
RealmFBTeam	渡劫助攻奖励	您帮助{0}渡劫成功，现发送奖励
RealmFBHelp	渡劫护法奖励	您帮助{0}渡劫成功，现发送奖励
GemToPlayer	宝石返还	您的背包空间不足，脱下的宝石已通过邮件发放，请注意查收！
SignToPlayer	签到奖励补发	您的背包空间不足，签到奖励已通过邮件发放，请注意查收！
ContineSignToPlayer	累计签到奖励补发	您的背包空间不足，累计签到奖励已通过邮件发放，请注意查收！
KirinHomeMail	麒麟之府奖励	您的背包空间不足，麒麟之府副本奖励物品已通过邮件发放，请注意查收！
VIPAwardMail	VIP礼包	您的背包空间不足，VIP礼包物品已通过邮件发放，请注意查收！
RefineStoveMail	炼丹产出物品	您的背包空间不足，炼丹产出物品已通过邮件发放，请注意查收！
PartyKing	仙盟宴会“答题王”奖励	您在仙盟宴会答题活动中，学识渊博、手速惊人获得答题王奖励！
QueenRelicsMail	娲皇遗迹奖励	您的背包空间不足，娲皇遗迹副本奖励物品已通过邮件发放，请注意查收！
ChaosDemonMail	混乱妖域奖励	您的背包空间不足，混乱妖域副本奖励物品已通过邮件发放，请注意查收！
ElderBattlefieldMail	上古战场奖励	您的背包空间不足，上古战场副本奖励物品已通过邮件发放，请注意查收！
ElderBattlefieldTopMail	上古战场积分王奖励	您在上古战场副本积分最多，奖励物品已通过邮件发放，请注意查收！
SealDemonMail	封魔坛奖励	您的背包空间不足，封魔坛副本奖励物品已通过邮件发放，请注意查收！
FamilyMatchRankMail	仙盟联赛积分奖	您在本场仙盟联赛积分获得第{0}名，获得丰厚奖励，请查收
FamilyMatchJoinMail	仙盟联赛参与奖	您在本场仙盟联赛中为本方仙盟出了一份力，赠予您参与奖，请查收。
FamilyMatchTitleMail	仙盟联赛称号	您在仙盟联赛获得称号，请查收。
FamilyMatchWinAllotMail1	连胜奖励分配	您得到了盟主分配的仙盟联赛连胜奖励！请注意查收！
FamilyMatchWinAllotMail2	未分配连胜奖励	您的仙盟联赛连胜奖励未分配，默认发放给盟主！请注意查收！
FamilyNameChange	仙盟改名通知	您的仙盟{0}已改名为{0}
XMZZWinCnt	仙魔之争胜利场次奖励	您在仙魔之争中胜利{0}场，奖励通过邮件发放，请注意查收！
XMZZTopScore	仙魔之争积分王	您在仙魔之争活动中获得{0}积分，排名第一，奖励通过邮件发放，请注意查收！
XMZZWin	仙魔之争胜利奖励	您所在阵营胜利，奖励通过邮件发放，请注意查收！
XMZZLose	仙魔之争失败奖励	您所在阵营失败，奖励通过邮件发放，请注意查收！
XMZZDogfall	仙魔之争平局奖励	大吉大利，喝酒吃肉！本次活动中您所在阵营与对方阵营战成平局，在这为您奉上旗鼓相当奖~
XMZZBet	仙魔之争押注	仙魔之争最终结果预测<Word info=RichTextMsgReplace Name=Bet id={0}/>，获得铜钱{0}
OSCBillAward1	开服强化排行奖励	您在开服强化排行活动中获得第{0}名.
OSCBillAward2	开服坐骑排行奖励	您在开服坐骑排行活动中获得第{0}名.
OSCBillAward3	开服宝石排行奖励	您在开服宝石排行活动中获得第{0}名.
OSCBillAward4	开服升级排行奖励	您在开服升级排行活动中获得第{0}名.
OSCBillAward5	开服境界排行奖励	您在开服境界排行活动中获得第{0}名.
OSCBillAward6	开服战力排行奖励	您在开服战力排行活动中获得第{0}名.
OSCTagAward1	开服强化目标奖励	您在开服强化目标活动中获得强化总等级{0}级奖励.
OSCTagAward2	开服坐骑目标奖励	您在开服坐骑目标活动中获得坐骑总等级{0}级奖励.
OSCTagAward3	开服宝石目标奖励	您在开服宝石目标活动中获得宝石总等级{0}级奖励.
OSCTagAward4	开服升级目标奖励	您在开服升级目标活动中获得角色{0}级的奖励.
OSCTagAward5	开服境界目标奖励	您在开服境界目标活动中获得境界{0}阶的奖励.
OSCTagAward6	开服战力目标奖励	您在开服战力目标活动中获得总战力{0}的奖励.
OnLineAward1	在线奖励补发	您有未领取的在线奖励，现通过邮件发放，请注意查收！
RedPackBack	仙盟红包未领取仙玉返还	您发放的仙玉红包未被领完，请查收退还的仙玉！
RunePackUnEnough	符印背包空间不足扫荡奖励	符印背包空间不足，符印塔扫荡奖励请查收！
FairyLeagueCompensation	联赛无对手积分补偿邮件	您在本轮仙盟联赛第{0}场未能正常获得个人积分奖励，根据您仙盟所在的<Word info=RichTextMsgReplace Name=LeagueLv id={0}/>级联赛级别，发放以下奖励补偿
FairyLeagueJoinReward	联赛无对手参与补偿邮件	您在本轮仙盟联赛第{0}场未能正常获得个人参与奖励，发放以下奖励补偿
HappyXBUnEnough	背包空间不足寻宝奖励	背包空间不足，寻宝奖励请查收！
ItemNoPickUp	战场打扫	在<Word info=Map id={0}/>打扫战场的时候发现您遗落了以下物品，请注意查收！
XXDForgetToPick	未领取的修行点	您昨日有{0}点修行点未领取，现将这部分修行点返还给您，请注意查收！
TodayDailyTask	今日限时活动	今日开启以下限时活动：</r>{0}
CodeRewardMail	兑换码奖励	您的兑换码奖励已发放，请注意查收！
WhiteTakeBagFull	极品白拿	您通过极品白拿活动购买{0}，由于您的背包空间不足，物品已通过邮件发放，请注意查收！
WhiteTakeJade	极品白拿钻石返还	系统已自动帮您将极品白拿钻石返还领取，请注意查收！
ConsumptionRebateMail	消费返利未领取奖励返还	消费返利活动已结束，您在该活动中累计消费满{0}仙玉，可领取该档位的回馈礼包，现已将您未领取的奖励通过邮件发放，请注意查收！
BossFHUnGetMail	Boss复活未领取奖励	您在Boss复活活动中有以下奖励未领取， 请注意查收！
